......*.....................................^^^
......................################..*...^^^
..............*.......#$$............#.....^^^^
..*...................#.......@......#.....^^^^
===...................#..............#....^^^^^
=======..........*....#######...######....^^^^^
.....=====................................^^^^^
........=====...................*.........^^^^^
..........========......................*.^^^^^
.......*......========....*...............^^^^^
..................=======.................^^^^^
*................*.....====................^^^^
.........................===...............^^^^
..........................====....*.........^^^
....................*.......====............^^^
..............................=====........^^^^
...........*................*...=====.^^^^^^^^^
.*................^^^^^.........^^=====^^^^^^^^
.......^^^^^   ^^^^^^^^^^^^^^^^^^^^^^^===^^^^^^
^^^^^^^^^^^^^ ^^^^^^^^^^^^^^^^^^^^^^^^^===^^^^^
^^^^^^^^^^^^^^^^^^^^^^^^^^^^^^^^^^^^^^^^===^^^^
