11111111111111111111111111111111111111111111111
11111111111111111111111111111111111111111111111
11111111111111111111111111111111111111111111111
11111111111111111111111111111111111111111111111
11111111111111111111111111111111111111111111111
11111111111,1111,1111/\111/\1111111111111111111
1111111111/(1/\1)\11_\ \_/ /1111111111111111111
1111111111|\_||_/|1< \_   _/ >11111111111111111
1111111111\______/11\|0   0|/\11111111111111111
111111111111_\/_111_(_  ^  _)\11111111111111111
11111111111(1()1)1/`\|V"""V|/`\\111111111111111
1111111111111{}111\  \_____/  /\111111111111111
1111111111111()111/\   )=(   /\\111111111111111
1111111111111{}11/11\_/\=/\_/11\1\1111111111111
11111111111111111111111111111111111111111111111
11111111111111111111111111111111111111111111111
11111111111111111111111111111111111111111111111
11111111111111111111111111111111111111111111111
11111111111111111111111111111111111111111111111
11111111111111111111111111111111111111111111111
11111111111111111111111111111111111111111111111